0000000000000000000000000000000000000000000
0000000000000000000000000000000000000000000
0000000000000000000000000000000000000000000
0000000000000000000000000000000000000000000
0000000000000000000000000000000000000000000
0000000000000000000000000000000000000000400
2200000000000000022000000220002220000066666
1122222222222222211000022112001110000000000
1111111111111111111000011111000100000000000
1111111111111111111000001100000000000000000
1111111111111111111000001000000000000000000
1111111111111111111000001000000000000000000
1111111111111111111000000000000000000000000