1111110000000000000000000000000000000000000000000000
1000010000000000000000000000000000002000000000000000
1000010000000000000000000000000000000000000000000400
1000011000000111000000000000000000000000000000666660
1011111111001111111100011000000000000000000000000000
1011111111111111111111111000000000000000000000000000
1010000000000000000000001100000000000000000000000000
1010000000000000000000001000000000000000000000000000
1010011000000000000000111000000000000000000000000000
1010000000000000000000111000000000000000000000000000
1010000000000000110000110000000000000000000000000000
1010000000000000000000110000000000000000000000000000
1010001110000000000000110000000000000000000000000000
1010000000000011000000111000000000000000000000000000
1010000000000000000000111000000000000000000000000000
1010000000000000000000111100000000000000000000000000
1010000000111110000000111100000000000000000000000000
1010000000000000000000001100000000000000000000000000
1010000000000000001110111000000000000000000000000000
1010000000000000000000110000000000000000000000000000
1010000000000000000000110000000000000000000000000000
1010000000001100000000111100000000000000000000000000
1000000000000000000000110000000000000000000000000000
1000000000000000000000110000000000000000000000000000
1111000111110111110110111000000000000000000000000000