000000000000000000000000000000000000000000000000000000000000000000000
000000000000000000000000000000000000000000000000000000000000000000000
000000000000000000000000000000000000000000000000000000000000000000000
000000000000000000000000000000000000000000000000000000000000000000040
000000000000000000000000000000000000000000000000000000000000020000666
000000000000000000000000000000000000000000000000000000000000110000000
020000000000000002555555522555222000000022000000000000000000000000000
112222222222222221100002211200111000000000000000000222220000000000000
111110000011111111100001111100010000000000002220000011100000000000000
111111666111111111100001111100010000000000002220000011100000000000000
11111111611111111111100000110000000000000000001112000000000000000000000
111111666111111111100000100000000000000000000000000000000000000000000
11111111611111111100000100000000000000000000111110000000000220022000
111111666111111100000000000000000000000000000000000000011111111111
