00000000000000000000000000000000000000000000000000000000000000000000000000000000000000000000000000000
00000000000000000000000000000000000000000000000000000000000000000000000000000000000000000000000000000
00000000000000000000000000000000000000000000000000000000000000000000010000000000111100000000000000000
00000000000000000000000000000000000000000000000000000000000000000000000001110000111100000001100000300
00000000000000000000000000000000000000000000000000000000000000001110000000000000000000000000000001110
00000000000000000000000000000001111000000000000001000111111000001110000000000000000000000000000000000
00000000144100000000000000000001111000000111100000000111111000000000000000000000000000000000000000000
10000000000000000000000000000001111000000111100000000111111000000000000000000000000000000000000000000
11000000000000000000000001111101111000000111100000000000000000000000000000000000000000000000000000000
11111111111111111110000001111101111000000111100000000000000000000000000000000000000000000000000000000
11111111111111111110000000000001111000000111100000000000000000000000000000000000000000000000000000000
11111111111111111110000000000001111000000111100000000000000000000000000000000000000000000000000000000
11111111111111111110000000000001111000000111100000000000000000000000000000000000000000000000000000000
111111111111111111100000000000011110000000000000000000000000000000000000000000000000000000000000000000
111111111111111111100000000000011110000000000000000000000000000000000000000000000000000000000000000000
111111111111111111100000000000011110000000000000000000000000000000000000000000000000000000000000000000
111111111111111111100000000000011110000000000000000000000000000000000000000000000000000000000000000000
