00000000000000000000000000000000000000000000000000000000000000000000000000000000000000000000000000000000
00000000000000000000000000000000000000000000000000000000000000000000000000000000000000000000000000000000
00000000000000000000000000000000000000000000000000000000000000000000010000000000000111000000001100000000
00000000000000000000000000000000000000000000000000000000000000000000000001221000000111000000001100000300
00000000000000000000000000000000000000000000000000000000000000000000000001221000000111000000000000012421
00000000000000000000000000000000000000000000000000000000000011111100000001221000000000000110000000000000
00000000110000000000000000000000000111000000000000000000000000000000000001221000000000000110000000000000
00000000000000000000000000000000000111000000000000000000000000000000000001221000000000000000000000000000
11000000000000000110000000000000000000000000000000011110000000000000000001221000000000000000000000000000
11777777777777777110000000000000000000000001111000000000000000000000000001221000000000000000000000000000
11111111111111111110000011111111111000000001111000000000000000000000000001221000000000000000000000000000
11111111111111111110000011111111111000000000000000000000000000000000000001221000000000000000000000000000
111111111111111111100000111111111110000000000000000000000000000000000000000000000000000000000000000010010
111111111111111111100000111111111110000000000000000000000000000000000000000000000000000000000000000000000
111111111111111111100000111111111110000000000000000000000000000000000000000000000000000000000000000010010
111111111111111111100000111111111110000000000000000000000000000000000000000000000000000000000000000000000
111111111111111111100000111111111110000000000000000000000000000000000000000000000000000000000000000000000

