00000000000000000000000000000000000000000000000000000000000000000000000000000000000000000000000000000
00000000000000000000000000000000000000000000000000000000000000000000000000000000000000000000000000000
00000000000000000000000000000000000000000000000000000000000000000000000000000000000000000000000000000
00000000000000000000000000000000000000000000000000000000000000000000000000000000000000000000000000000
00000000000000000000000000000000000000000000000000000000000000000000000000000000000000000000000000000
00000000000000000000000000000000000000000000000000000000000000000000000000000000000000000000000000000
00000000000000000000000000000000000000000000000000011100000010100000000000000000141000000001100000300
00000000000000000000000000000000000000000001111000011100000001010000000000111000000000000000000012421
00000000000000000000000000000000000000000001111000000000000000000001441000000000000000012000000000000
00000000101000000000000000000000000014410000000000000000000000000001441000000000000000000021000000000
00700000000000000000000000000444000014410000000000000000000000000000000000000000000000000000000000000
11000000000000000000000000000444000000000000000000000012100000000000000000000000000000000000000000000
11000000000000000000000111000444000000000000000000000000000000000000000000000000000000000000000000000
11111111444411111110000111000444000000000000000000000000000000000000000000000000000000000000000000000
11221111411111122110000111000444000000000000000000000000000000000000000000000000000000000000000000000
11111111444411111110000111000444000000000000000000001441000000000000000000000000000000000000000000000
11111111111411111110000111000444000000000000000000000000000000000000000000000000000000000000000000000
11221111444411122110000111000000000000000000000000000000000000000000000000000000000000000000000000000
11111111111111111110000110000000000000000000000000000000000000000000000000000000000000000000000000000
11112211111112211110000111000000000000000000000000000000000000000000000000000000000000000000000000000