00000000000000000000000000000000000000000000000000000000000000000000000000000000000000000000000000000
00000000000000000000000000000000000000000000000000000000000000000000000000000000000000000000000000000
00000000000000000000000000000000000000000000000000000000000000000000000000000000000000000000000000000
00000000000000000000000000000000000000000000000000000000000000000000000001100000000000000011000000300
00000000000000000000000000000000000000000000000000000000000000000000000001100000001100011000000002420
0000000000000000000000000000000000000000000000000000000000000001444100000001100000001100011000000000000
00000000000000000000000000000000000000000000000010100000000000000000011001100000000000000000000000000
10070000000000070000000000000000000000000011100000000000111100000000011001100000000000000000000000000
11000000000000000110000000000000000000000011100000000000111100000000000001100000000000000000000000000
11000000000000000110000000000000000000000000000000000000000000000000000001100000000000000000000000000
11111110000011111111100011111000000000000000000000000000000000000000000001100000000000000000000000000
11111111111111111110000011111000000111111000000000011110000000000001111001100000000000000000000000000
11111111111111111110000011111000000111111000000000000000000000000000000001100000000000000000000000000
11111111111111111110000011111000000000000000000001111111000000000000000001100000000000000000000000000
11111111111111111110000011111000000000000000000000000000000000000000000001100000000000000000000000000
11111111111111111110000011111000000000000000000000000000000000000000000001100000000000000000000000000
11111111111111111111000011111000000000000000000000000000000000000000000001100000000000000000000000000
