00000000000000000000000000000000000000000000000000000000000000000000000000000000000000000000000000000
00000000000000000000000000000000000000000000000000000000000000000000000000000000000000000000000000000
00000000000000000000000000000000000000000000000000000000000000000000010000000000000000000000100000000
00000000000000000000000000000000000000000000000000000000000000000000000001110000000000000001100000300
00000000000000000000000000000000000000000000000000000000000000000000000000000000000000000000000016161
00000000000000000000000000000001110000000000000000000000000001444100000000000000000001100000000000000
00000000144100000000000000000000000000000000000000000000000000000000000000000000000011000000000000000
00000000000000000000000000000000000000000000000000000000000000000000000000000000000000000000000000000
11000000000000000110000000110000000000000000000000000111000000000000000000000000000000000000000000000
11000000000000000000000000000000000000111100000000000000000011111000001111100000000000000000000000000
11111111111111111111000011111111111100000000011000000000000000000000000000000000000000000000000000000
111110111011011111110000000000000000000000000000000000000000000000000000000000000000000000000000000000
11110111110111101111110000000000000000000000000000010010000000000000000000000000000000000000000000000000
11111111111111111110000000000000000000000000000000000000000000000000000000000000000000000000000000000
11111111111111111110000000000000000000000000000000000000000000000000000000000000000000000000000000000
11111111111111111110000000000000000000000000000000000000000000000000000000000000000000000000000000000
11111111111111111110000000000000000000000000000000000000000000000000000000000000000000000000000000000
