00000000000000000000000000000000000000000000000000000000000000000000000000000000000000000000000000000000000000000000000000000000000000
00000000000000000000000000000000000000000000000000000000000000000000000000000000000000000000000000000000000000000000000000000000000000
00000000000000000000000000000000000000000000000000000000000000000000000000000000000000000000000000000000000000000000000000000000000000
00000000000000000000000000000000000000000000000000000000000000000000000000000000000000000000000000000000000000000000000000000000000000
00000000000000000000000000000000000000000000000000000000000000000000000000000000000000000000000000000000000000000000000000000000000000
00000000000000000000000000000000000000000000000000000000000000000000000000000000000000000000000000000400000000000000000000000000000000
00000000000000000000000000000000000000000000000000000000000000000000000000000000000000000000000000006660000000000000000000000000000000
00000000000000000000002200000000000022000000220000000200000000000000022000000000000000000000000000000000000000000000000000000220000000
22000000000000000220000000000000000000000000000110000000000000000000000000000000000000000000000000000002200000000000000022000000000000
11222222222222222110000002222222222222000022222222222222000002222222222222200000022222222222000220022001122222222222222211000000222222
11111111111110000000000001111111111111000011111111111111000000000000000002200000000000000000000000000001111111111111000000000000111111
11111166611110000000000000000000000000000000000000000000000000000000000000000000000220000000000000000001111116661111000000000000000000
11111111611110000000000000000000000000000000000000000000000000000000000000000000000000000000000000000001111111161111000000000000000000
11111166611110000000000000000000000000000000000000000000000000000222222200000000000000000000000000000001111116661111000000000000000000
11111111611110000000000000000000000000000000000000000000000000000000000000000000000000000000000000000001111111161111000000000000000000
11111166611110000000000000000000000000000000000000000000000000000000000000000000000000000000000000000000000000000000000000000000000000