00000000000000000000000000000000000000000000000000000000000000000000000000000000000000000000000000000
00000000000000000000000000000000000000000000000000000000000000000000000000000000000000000000000000000
00000000000000000000000000000000000000000000000000000000000000000000000001210000000000000001100000300
00000000000000000000000000000000000000000000000000000000000000000000000000000000000000000000000012421
00000000000000000000000000000001210000000000000000000000000001444100000000000000000001200000000000000
00000000144100000000000000000000000000000000000000000000000000000000000000000000000021000000000000000
00007000000000700000000000000000000000000000000000000000000000000000000000000000000000000000000000000
11000000000000000110000000110000000000014410000000000121000000000000000000000000000000000000000000000
1100000000000000110000000000000000000000000000000000000000000000000000000000000000000000000000000000
11111111444411111110000000000000000000000000000000000000000000000000000000000000000000000000000000000
11221111411111122110000000000000000000000000000000000000000000000000000000000000000000000000000000000
11111111444411111110000000000114411000000000000014410000000000000000000000000000000000000000000000000
11111111111411111110000000000000000000000000000000000000000000000000000000000000000000000000000000000
11221111444411122110000000000000000000000000000000000000000000000000000000000000000000000000000000000
11111111111111111110000000000000000000000000000000000000000000000000000000000000000000000000000000000
11112211111112211110000000000000000000000000000000000000000000000000000000000000000000000000000000000